				NO 						textures/test/north.xpm	



					SO 					./textures/   test/south.xpm




		EA textures/test/east.xpm





			F			20			,					20			,		7	


	C						6						,				200					, 	77	



									WE textasd





		111111111111111
	111111111111111
1111111111111111