






					       C          225,        30,          0_C










							NO fgerg fgh656_NO





























		SO ./dfsdf_SO


















F 20,      100,        0_F



















     EA 111_EA




			WE								./sd	fsdf_WE







			
										111111111111111111      1111111
1011111000000000000
	1111111




















					1000000000	1
                    1000000000	110000000000001
                   10110000011 10000000000001
                  1001000000000000000000001
                 111111111011000001110000000000001
                100000000011000001110111111111111
               11110111111111011100000010001
              11110111111111011101010010001
             11000000110101011100000010001
			100000000        00000001100      000010001
		   10000000000000001101010010001
		  11000001110101011111011110N0111
         11110111 1110101 101111010001
		11111111 1111111 111111111111