NO ./maps/textures/simonkraft/wet_sponge.xpm




SO ./maps/textures/simonkraft/wet_sponge.xpm
WE ./maps/textures/simonkraft/wet_sponge.xpm
EA ./maps/textures/simonkraft/wet_sponge.xpm

F 164,169,78
C 153,204,255

11111111111111111111111111
101000001000000000001
101010101111111100011
100010100010000010001
111110101111101011101
100000101000101000001
10111110101110111111
10100001010100000101
11111111111111111111 
101011111010111110101
101010S01010001010111
111111111111111111111
101110101010101010101
100000101010001010001
111111101011111011101
10000010000100010001
101110101110101110111
101000100000100010101
101011111111111010101
100010000000000010001
101010111011111111101
101000001000000000001
111111111111111111111




