F 139,99,58
C 171,154,137

NO ./maps/textures/simonkraft/bookshelf.xpm
SO ./maps/textures/simonkraft/bookshelf_01.xpm
WE ./maps/textures/simonkraft/bookshelf_02.xpm
EA ./maps/textures/simonkraft/bookshelf_03.xpm

111111
10001
111S1
 10101
 11111

