F 139,99,58
C 171,154,137

NO textures/simonkraft/bookshelf.xpm
SO textures/simonkraft/bookshelf_01.xpm
WE textures/simonkraft/bookshelf_02.xpm
EA textures/simonkraft/bookshelf_03.xpm

111111
10101
111S1
 10101
 11111

